1111111111111111111111111111
1P10000000100000001000000011
1010111010101111111011111011
1010100010100000001010001011
1010101110111011101011101011
10101010C0001010001000001011
1010101111101010111111101011
1010100010001010000000001011
1011101010111011111111111011
1000101010100000001000001011
1110111010111111111011101011
1010000010001000100010100011
1011111111101010101110111011
1000000000000010001000000E11
1111111111111111111111111111
1111111111111111111111111111
