1111111111111111111111111111
1P00000000010000000000000011
1011111110101111111111101011
1000000010100000000010001011
1111111010111111111010111011
1000000010000000C01000001011
1011111110111111111011111011
1010000000100000001000000011
1010111111101111101111111011
1010100000001000100000001011
1010101111111010111111101011
1000101000000010100000100011
1111101011111110101110101111
1000001000000000100010000E11
1111111111111111111111111111
1111111111111111111111111111
