1111111111111111111111111111
1P000000000000000000000000E1
1011111111111111111111111011
1000000000000000000000000011
1011111111111111111111111011
100000000C000000000000000011
1011111111111111111111111011
1000000000000000000000000011
1111111111111111111111111111
1000000000000000000000000011
1011111111111111111111111011
1000000000000000000000000011
1011111111111111111111111011
1000000000000000000000000011
1111111111111111111111111111
1111111111111111111111111111
