1111111111111111111111111111
1P00000100000000100000000011
1011111011111110101111111011
1000001000000010100000010011
1111101011111010111111011011
1000101010001010000000C01011
1010101010111011111111101011
1010101000100010000000001011
1010101111101110111111111011
1010000000100010000000001011
1111111110101110111111111011
1000000010100010000000000011
1011111010111011111111111011
1000001000000000000000000011
10111111111111111111111110E1
1111111111111111111111111111
