1111111111111
100000P000001
10000C000E001
1111111111111