1111111111111111111111111111
1P00000001000000000000000011
1011111010111111111111101011
1000001010000000000010001011
1111101010111111111010111011
10001010001000000C1000001011
1010101111101111111011111011
1010100000001000001000000011
1010111111111011101111111011
1010000000000010000000001011
1111111111111010111111101011
1000000000000010100000100011
1011111111111110101110101111
1000000000000000100010000E11
1111111111111111111111111111
1111111111111111111111111111
